##########
#********#
#*%***o**#
#***o****#
#******&*#
##########