##################
#@**+**#B**#*****#
#H@*K*oL***L*o***#
#+**o%~~#L+^*+***#
#*H@~~~~&*^*@****#
##################