##############
#************#
#************#
#***#****#***#
#***#@**@#***#
#***#****#***#
#***######***#
#*****%******#
#************#
#************#
#*********&**#
##############

