#######################
#*B**!^^^^^*@*****@@@@#
#*****^^^&**********@@#
#!L!L!K**@*H*****ooooo#
#.@+**+K*~~~~******o**#
#..K@**H**~~~****%****#
#.*+**+****~~*********#
#*********************#
#*********************#
#######################
