#######################
#*B**!^^^^^*@*********#
#*****^^^&************#
#!L!L!K%*@*H**********#
#.@+**+K*~~~~*********#
#..K@**H**~~~*********#
#.*********~~*********#
#*********************#
#*********************#
#######################
